%%%%%%%%
%    P %
%      %
%.    o%
%%%%%%%%
