%%%%%
%   %
% % %
% %P%
% % %
% % %
% % %
%.% %
%%%%%